1111111111111111111111111111111
199C9999919991C19991999C1199991
1911191191999191999191191191191
1911191191999191999191199991191
1911191191999191999191111191191
1911191191111191111191111191191
1999999999999999999999999991191
1911191111111191111191191111191
1911191111111191111191191111191
1911199991199999999991199991191
1911191191191111191191191191191
1911191191191999191191191191191
1999991199991999191199991199991
1111191111191999191111191111191
1111191111191999191111191111191
1999991199991999191199991199991
1911191191191999191191191191191
1911191191191111191191191191191
1911199991199999999991199991191
1911191111111191111191191111191
19111911111111P1111191191111191
1999999999999999999999999991191
1911191191111191111191111191191
1911191191111191111191111191191
1911191191111191111191199991191
1911191191111191111191191191191
199C9999911111C11111999C1199991
1111111111111111111111111111111