1111111111111111111111111111111
1CC9CCCCC1000191000CCCC911CCCC1
1C111C11C10001C10001C11C11C11C1
1C111C11C10001C10001C11CCCC11C1
1C111C11C10001C10001C11111C11C1
1C111C11C11111C11111C11111C11C1
1CCCCCCCCCCCCCCCCCCCCCCCCCC11C1
1C111C11111111011111C11C11111C1
1C111C11111111011111C11C11111C1
1C111CCCC11000000000C11CCCC11C1
1C111C11C11011111011C11C11C11C1
1C111C11C11010001011C11C11C11C1
1CCCCC11C00010001011CCCC11CCCC1
11111C11111010001011111011111C1
11111C11111010001011111011111C1
1CCCCC11C00010001011CCCC11CCCC1
1C111C11C11010001011C11C11C11C1
1C111C11C11011111011C11C11C11C1
1C111CCCC11000000000C11CCCC11C1
1C111C11111111011111C11C11111C1
1C111C11111111011111C11C11111C1
1CCCCCCCCCCCCCCCCCCCCCCCCCC11C1
1C111C11C11111C11111C11111C11C1
1C111C11C10001C10001C11111C11C1
1C111C11C10001C10001C11CCCC11C1
1C111C11C10001C10001C11C11C11C1
1CC9CCCCC1000191000CCCC911CCCC1
1111111111111111111111111111111