1111111111111111111111111111111
100C0011000000C00000011C1100001
1011101101111101111101101101101
1011101100000000000001100001101
1011101101101101101101111101101
10111011011011E1101101111101101
1000000000000000000000000001101
1011101111111101111101101111101
1011101111111101111101101111101
1011100001100000000001100001101
1011101101101111101101101101101
1011101101101000101101101101101
1000001100001000101100001100001
1011101111101000101111101111101
1011101111101000101111101111101
1000001100001000101100001100001
1011101101101000101101101101101
1011101101101111101101101101101
1011100001100000000001100001101
1011101111111101111101101111101
10111011111111P1111101101111101
1000000000000000000000000001101
1011101101101101101101111101101
1011101101101101101101111101101
1011101100000000000001100001101
1011101101111101111101101101101
100C0011000000C00000011C1100001
1111111111111111111111111111111