1111111111111111111111111111111
100C0011000000C00000011C1100001
10111011011011E1101101101101101
1000000000000000000000000001101
10111011111111P1111101101111101
1011101100000000000001100001101
100C0011000000C00000011C1100001
1111111111111111111111111111111